1111111111111111111111
1P00000000000000000001
1001000000000111111001
1001000000000000001001
10010000000000000C1001
1001000100000111111001
1001C001000001C0000001
1001111111000100000001
100000C100000111111001
1000000000000000000001
1E00000000000000000001
1111111111111111111111