111111111111111111111
1000001000C0001010001
100C00000111100010001
111110000111110011111
100011111000000000001
11000C00P0C00100100E1
111111111111111111111
111111111111111111111