111111111111111111
1000001000C1010001
100C00000110010001
11111000C110011111
100011110000000001
11000C00P0C00100E1
111111111111111111
111111111111111111
111111111111111111
111111111111111111
111111111111111111
111111111111111111
111111111111111111
111111111111111111
111111111111111111
111111111111111111
111111111111111111
111111111111111111
111111111111111111