111111111111111111111
1P00001000C0001000001
100C00000111100000001
111110001111110000111
100011111000000100001
11000C0000C00100100E1
111111111111111111111