111111111111111111111111
1P0000000000000000000001
101111111100001111111001
101000000000000000001001
101000000000000000010001
101111111100000000100001
100000000100C00001000001
100000000100000010000001
101111111100000010000001
1E000000000C000000000001
111111111111111111111111